22
22
######################
######################
#..........#.....#####
##.#.#.##....###.#.*.#
#....#....##..#....#.#
#.##...#.####...##.#.#
#*...#.#......#..#...#
#.##.#...x##x......###
...#.#.#.####.##.#....
##.#.....x##x.#..#.#.#
##.#.#.#........##.#.#
##.....##.##.#*......#
##.###.##....#.#.#.#.#
...##..##.##.....#*...
##.##.#....#.#####.#.#
##.##....#.#.........#
#...#.##.#...##.#.##.#
#.#.#....##.###.#.#..#
#.*.#.#.##...........#
#.#.#....#.#.###.#.#.#
......##...#.....#....
######################